%%%%%%%
%G...o%
% .%. %
%G. .P%
%%%%%%%
