XXXXXXXXXXXXXXXXXXX
X.R.D.T...T.......X
X..XXXXDXXXXXXXXX.X
X..XXXX.R.T.T.....X
XH.XXXXXXXXXXX...MX
XXXXXXXXXXXXXXXXXXX
