XXXXXXXXXX
XR..T.XXXX
X.XXX.XXXX
XHXXXT..MX
X.XXX.XXXX
X.....XXXX
XXXXXXXXXX
