XXXXXXXXXXXXXXXXXXX
XR..D.T...D.R.D...X
X..XXXXDXXXXXXXXX.X
X..XXXX.R.T.T.....X
XH.XXXXXXXXXXX...MX
XXXXXXXXXXXXXXXXXXX
