XXXXXXXXXXXXXX
X..T..R..D..TX
X.XXXXXXXXXX.X
XHXXXXXXXXXXMX
X.XXXXXXXXXX.X
X.........T..X
XXXXXXXXXXXXXX
