XXXXXXXXXXXXXX
X..T..D..R..TX
X.XXXXXXXXXX.X
XHXXXXXXXXXXMX
X.XXXXXXXXXX.X
X....T...D...X
XXXXXXXXXXXXXX
