XXXXXXXXXXXXXX
XR..X.R.X..RDX
X.X.T.X.T.XX.X
X.XXXXXXXXXXMX
XH..R.D..T...X
XXXXXXXXXXXXXX
